5,5
XSXXX
X  XX
XX XX
XX  X
XXXEX