5,5
XSXXX
XXXXX
XXXXX
XXXXX
XXXEX